----------------------------------------------------------------------------------------------
-------------------------------------------YYYY-----------------------------------------------
-------------------------Y-----------YYYYYY---------------------------------------------------
---------------------BBBBYBBBB---------------------------------BBBB---------------------------
-----------BBBBB---------Y--------------------BB--------------B----BBBB---B-------------------
----------B--------------Y-------------------B--BBBBB------BBB------------BBBBB---------------
--BBBYYY-----------------Y------------------B----------YYY------------------------------------
----BY--------------------BBBBBBB----------B--------------------------------------------------
----BY-------------------------------BBBBB---------------YYYYYYYYYYY--------------------------
----BY----YYYYYYY--------------------------------------Y-----------------YYYYYY---------------
----BY----------------B---------YYYY-----------------Y----------------------------------------
----BY-------------YYYYYYYYBB-----------------YYYYYYY-----------------------------------------
----BY----------------------------------------------------------------------------------------